FFFFFFFFFFFF
FFFFFFFFFFFF
FFFFFFFFFFFF
BBFBFFFBFBBF
BFFBBFFBFBFB
BBFBFBFBFBFB
BFFBFFBBFBFB
BBFBFFFBFBBF
FFFFFFFFFFFF
FFFFFFFFFFFF
FFFFFFFFFFFF
FFFFFFFFFFFF