WWWWWWWWWWWW
WDBBFFWFFFFW
WFFBFFDBFFFW
WFFFFFWFFFFW
WBFFFFWFFFFW
WFFFFFWFFFFW
WWWWWWWFFFFW
WWWFFWWWFWWW
WFFFBFFFFFWW
WFFFWWWFDBFW
WPFFFDWFFFFW
WWWWWWWWWWWW