WWWWWWWWWWWW
WBFFFFFFFFFW
WFFFFFFFDFFW
WFFFFFWWWWWW
WFFFFFWFFFFW
WWWFWWWFFBFW
WFDFFFFDFFFW
WFFFFFFFFFFW
WFFFFFBBFFFW
WFFFFFFFFFBW
WPFFFFFFFBBW
WWWWWWWWWWWW