WWWWWWWWWWWW
WFFFFFFFFFFW
WFFFFFFFDFFW
WFFFFFFFFFFW
WWWWBWWWWWWW
WFFFFFFFFFFW
WFFFFFFFFFFW
WFFFFFFFFFFW
WWWWWWWWFWWW
WFFFFFFFBFFW
WPFFFFFFFFFW
WWWWWWWWWWWW