WWWWWWWWWWWW
WFFFFFFFFFFW
WFFFFFFFFFFW
WFFFFFWFFBFW
WFFFFFWFBBFW
WWWFWWWFBFFW
WFFDFFWDFFFW
WWWWWWWWWWFW
WDFFFFBFFFBW
WFFFFFWFFFFW
WPFFFFWFFFFW
WWWWWWWWWWWW