WWWWWWWWWWWW
WFFFFFFFFFFW
WFFFDFFFFFFW
WFFFFFFFFFFW
WBBWWWWWWWWW
WFFFFFFFFFFW
WWWWWWWWWFFW
WFFFFFFFWFFW
WFFFFFFFWWFW
WFFFFFFFBFFW
WPFFFFFWFFDW
WWWWWWWWWWWW