WWWWWWWWWWWW
WFFFFFFFFFFW
WFFFCFFFFFFW
WFFFFFFFFFFW
WBBWWWWWWWWW
WFFFFFFFBFFW
WWWWWWWWWFFW
WFFFFFFFWFFW
WFFFFFFFWWFW
WFFFFFFFBFFW
WPFFFFFWFFFW
WWWWWWWWWWWW