WWWWWWWWWWWW
WFFFFFFFFFFW
WFFFFFWFFBFW
WFFFFFWFBBBW
WFFBFFWBBFFW
WWWFWWWBBFFW
WFFCFFWWWFFW
WWWWWWFFWWFW
WFFFFFBFFFBW
WFFFFBFWBBFW
WPFFFFWFFFFW
WWWWWWWWWWWW